....................
....................
.....1..............
....................
...2.....1..........
....................
...@..3.............
GGGGGGGGGGGGGGGGGGGG