############
#..........#
#....##....#
#..........###########################
#.......##.......#...................#####
#....@..##.....#......#...................#
#....................###.....#...........##
#...###....##############################
#..........#
#...#....#.#
############